1,1,1,0,0,0,3,3,3,0,2,0,0,0,0
1,1,1,2,0,0,3,3,3,0,0,0,2,0,0
1,1,1,0, 0,0, 0,0,4,4,4,4,4,4,0
0,0,0,7,7,7,7 ,0,5,5,4,5,5,4,0
2,0,0,7,7,7,7,0,4,5,5,5,5,4,0
0,0,0,0,0,0,0,2,4,4,4,4,5,4,2
1,1,1,0,0,0,0,0,4,5,4,5,5,4,0
1,1,1,0,0,0,3,3,4,5,5,5,5,4,0
1,1,1,0,0,0,3,3,4,4,4,4,5,4,0
0,0,2,0,0,0,3,3,0,0,0,0,0,2,2
0,0,0,0,0,2,2,0,0,0,0,0,0,2,2
0,0,0,0,0,2,2,0,0,0,3,3,0,0,0
0,0,0,0,2,0,0,0,0,0,6,6,2,0,0
2,2,0,0,2,2,0,0,0,0,6,6,2,0,0
2,2,0,0,2,2,0,0,0,0,6,6,0,0,0